size 2i 18 10

:0
##################
#........#.......#
#........#.......#
#........|.......#
#........#.......#
#........####-####
#................#
#....###.........#
#................#
##################

:1
##################
#................#
#................#
..................
.................#
#................#
#................#
#................#
#................#
##################

:2
##################
##################
###....###########
###....###########
###....###########
##################
##################
##################
##################
##################

:entities 
..................
.1................
..................
..................
..................
..................
..................
..................
..................
..................