size 2i 18 10

:1
########## #######
#        ###     #
#   #    |       #
#        ###     #
#  ##-## # ###-###
#        |   #   #
#        #####   #
#    #   #       #
#        #       #
############ #####

:2
# # # # #   # # # 
         # #     #
#   #    |        
         ###     #
#  ##-##   ###-## 
         |   #   #
#         ####    
     #   #       #
#                 
 # # # # # # # # # 

:entities 
..................
.1................
..................
..................
..................
..................
..................
..................
..................
..................