size 2i 18 10

:0
##################
#........#.......#
#........#.......#
#........|.......#
#........#.......#
#........####-####
#................#
#....###.........#
#................#
##################

:1
##################
#........#.......#
#........#.......#
.........#........
.........#.......#
#........#########
#........#.......#
#........#########
#........#.......#
##################

:2
##################
#........#.......#
#........#.......#
#........#........
#........#.......#
#........#########
#........##.###.##
#........##.###.##
#........##.###.##
##################

:3
##################
##################
###....###########
###....###########
###....###########
##################
##################
##########.###.###
##################
##################

:entities 
..................
.1................
..................
..................
..................
..................
..................
..................
..................
..................