size 2i 20 10

end0 str "level1.map"

:0
111111111222222222
1X...............2
1................2
1................2
1................2
1.......E........2
1................1
1................1
1................1
1................1
1................1
111111111111111111 